20 12
0 0
11 11 11 11 11 11 11 11 11 11 11 11 11 11 11 11 11 11 11 11 
11 10 10 10 10 10 10 10 10 10 10 10 10 10 10 10 10 10 10 11
11 10 0  1  2  3  4  5  0  1  2  3  4  5  6  0  1  2  10 11 
11 10 10 10 10 10 10 10 10 10 10 10 10 10 10 10 10 3  10 11
11 10 0  5  4  3  7  2  1  0  5  4  3  2  1  0  5  4  10 11
11 10 1  10 10 10 10 10 10 10 10 10 10 10 10 10 10 10 10 11
11 10 2  3  4  5  0  1  2  3  4  5  0  1  8  2  3  4  10 11
11 10 10 10 10 10 10 10 10 10 10 10 10 10 10 10 10 5  10 11 
11 10 2  1  0  5  4  3  2  9  1  0  5  4  3  2  1  0  10 11
11 10 10 10 10 10 10 10 10 10 10 10 10 10 10 10 10 10 10 11
11 11 11 11 11 11 11 11 11 11 11 11 11 11 11 11 11 11 11 11
11 11 11 11 11 11 11 11 11 11 11 11 11 11 11 11 11 11 11 11